000020021001010112010201101101
100100010001000100000100100010
100100102010000000000000100000
000011021010100011000000100110
100210000000101101000000000000
000202021010210102201000101001
100100001100000100001100010000
000002110011101000000011001020
112001001010022000102010001100
000022021000000200010100110012
000002002000020211211002201000
010010002101000200010120001000
210000001012000010011000000000
000021010020000000100100100000
000000001000001111011012020001
000010000010220101000000011001
210000010000101000102002121100
020120000010012101012112201202
102001002100010002002000001000
000000120000010210000020002001
010220001100010120100000000110
011000002000201001001000011000
000010101102000001101100110100
100011100000121100001111001111
201101000201100002120000010000
001011000000000110210201001000
000111001100010001000120202011
001001010000010010100110010012
011020020100001101000100021010
011202200000202000110010010112
